0,0,0,0,0,0
4,1,2,3,4,5
0,1,2,3,4,5
4,1,2,3,4,5
0,1,2,3,4,5
0,1,2,3,4,5